7,5
#####
#pog# 
# og# 
# og# 
# og# 
# og# 
#####
