8 10
##########
#        #
#        #
# pogg   #
#        #
#        #
o        #
##########
